{
    "height":12,
    "width":10,
    
    "value":[
        0,0,0,0,0,0,0,0,0,0,
        0,0,0,0,0,0,0,0,0,0,
        0,0,0,0,0,0,0,0,0,0,
        0,0,0,0,0,0,0,0,0,0,
        0,0,0,0,0,0,0,0,0,0,
        0,0,0,0,0,0,0,0,0,0,
        0,0,0,0,0,0,0,0,0,0,
        0,0,0,0,0,0,0,0,0,0,
        0,0,0,0,0,0,0,0,0,0,
        0,0,0,0,0,0,0,0,0,0,
        0,39,0,0,0,0,0,0,39,0,
        0,0,0,0,0,0,0,0,0,0
    ],
    
    "walk":[
        1,1,1,1,1,1,1,1,1,1,
        1,0,0,0,0,0,0,0,0,1,
        1,0,0,0,0,0,0,0,0,1,
        1,0,0,0,0,0,0,0,0,1,
        1,0,0,0,0,0,0,0,0,1,
        1,0,0,0,0,0,0,0,0,1,
        1,0,0,0,0,0,0,0,0,1,
        1,0,0,0,0,0,0,0,0,1,
        1,0,0,0,0,0,0,0,0,1,
        1,0,0,0,0,0,0,0,0,1,
        1,1,0,0,0,0,0,0,1,1,
        1,1,1,1,1,1,1,1,1,1

    ],   
    
    "background":[
        15,0,0,0,0,0,0,0,0,15,
        15,17,17,17,17,17,17,17,17,15,
        15,17,17,17,17,17,17,17,17,15,
        15,17,17,17,17,17,17,17,17,15,
        15,17,17,17,17,17,17,17,17,15,
        15,17,17,17,17,17,17,17,17,15,
        15,17,17,17,17,17,17,17,17,15,
        15,17,17,17,17,17,17,17,17,15,
        15,17,17,17,17,17,17,17,17,15,
        15,17,17,17,17,17,17,17,17,15,
        15,17,17,17,17,17,17,17,17,15,
        0,0,0,0,0,0,0,0,0,0
    ]


}