{
    "height":12,
    "width":10,
    
    "value":[
        0,0,0,0,0,0,0,0,0,0,
        0,0,0,0,0,0,0,0,0,0,
        0,0,0,0,0,0,0,0,0,0,
        0,0,0,0,0,0,0,0,0,0,
        0,0,0,0,0,0,0,0,0,0,
        0,0,0,0,0,0,0,0,0,0,
        0,0,0,0,0,0,0,0,0,0,
        0,0,0,0,0,0,0,0,0,0,
        0,0,0,0,0,0,0,0,0,0,
        0,0,0,0,0,0,0,0,0,0,
        0,39,0,0,0,0,0,0,39,0,
        0,0,0,0,0,0,0,0,0,0
    ],
    
    "walk":[
        1,1,1,1,1,1,1,1,1,1,
        1,0,0,0,0,0,0,0,0,1,
        1,0,0,0,0,0,0,0,0,1,
        1,0,0,0,0,0,0,0,0,1,
        1,0,0,0,0,0,0,0,0,1,
        1,0,0,0,0,0,0,0,0,1,
        1,0,0,0,0,0,0,0,0,1,
        1,0,0,0,0,0,0,0,0,1,
        1,0,0,0,0,0,0,0,0,1,
        1,0,0,0,0,0,0,0,0,1,
        1,0,0,0,0,0,0,0,0,1,
        1,1,1,1,1,1,1,1,1,1

    ],   
    
    "background":[
        9,0,0,0,0,0,0,0,0,9,
        9,9,9,9,9,9,9,9,9,9,
        9,9,9,9,9,9,9,9,9,9,
        9,9,9,9,9,9,9,9,9,9,
        9,9,9,9,9,9,9,9,9,9,
        9,9,9,9,9,9,9,9,9,9,
        9,9,9,9,9,9,9,9,9,9,
        9,9,9,9,9,9,9,9,9,9,
        9,9,9,9,9,9,9,9,9,9,
        9,9,9,9,9,9,9,9,9,9,
        9,9,9,9,9,9,9,9,9,9,
        9,0,0,0,0,0,0,0,0,9
    ]


}